sample1	float
sample2	float
sample3	float
sample4	float
sample5	float
random_type	str
bool_type	str
bool_type2	str
abs_data	float
list_data	list
random_type_counter	str
bool_type2_counter	str
bool_type_counter	str
list_data_counter	str
sample1_avg	float
sample1_sum	float
sample1_max	float
sample1_min	float
sample1_std	float
sample2_avg	float
sample2_sum	float
sample2_max	float
sample2_min	float
sample2_std	float
sample3_avg	float
sample3_sum	float
sample3_max	float
sample3_min	float
sample3_std	float
sample4_avg	float
sample4_sum	float
sample4_max	float
sample4_min	float
sample4_std	float
sample5_avg	float
sample5_sum	float
sample5_max	float
sample5_min	float
sample5_std	float
abs_data_avg	float
abs_data_sum	float
abs_data_max	float
abs_data_min	float
abs_data_std	float
name	str
dist	float
support	float
